
             F             128,                       128, 129
        NO       ./xpm/NO.xpm


      SO      ./xpm/SO.xpm          
	                          

            EA              ./xpm/EA.xpm





WE             ./xpm/WE.xpm












C                                          65,                105,     225













            1111111111111111111111111
            1000000000110000000000001
            1011000001110000000000001                          111111
            100100000000000000000000111111111             11111110111
            111111111011000001110000000000001                   11111
            100000000011000001110111101111111
            11110111111111011100000010001
            11110111111111011101010010001
            11000000110101011100000010001
            10000000000000001100000010001
            10000000000000001101010010001
            11000001110101011111011110N0111
            11110111 1110101 101111010001
            11111111 1111111 111111111111
                      111
                    1111111
                  11111111111
