NO ./xpm/NO.xpm
SO ./xpm/SO.xpm
WE ./xpm/WE.xpm
EA ./xpm/EA.xpm
F 119,136,153
C 225,205,0


111111111111111111111111111
100000000000000000000000001
100001000000000000000000001
100000000000000000000100001
10000000000W000000000000001
100000000000000010000000001
110000000000000000000000001
111111111111111111111111111
